# Width
23
# Height
26
# Ending type (just a place holder)
-2
# Amount of sprites on width
4
# Amount of sprites on height
1
# Data store for referencing against
30000000000000000000000
30000000000000000000000
30000000000000000000000
30000000000000000000000
30000000000000000000000
30000000000000000000000
30000000000000000000000
30000000000000000000000
30000000000000000000000
30000000000000000000000
30000000000000000000000
30000000000000000000000
30000000000000000000000
30000000000000000000000
30000000000000000000000
30000000000000000000000
30000000000000000000000
30000000000000000000000
30000000000000000000000
30000000000000000000000
30000000000000000000120
30000000012000000000000
30000000000000000000000
30000000000000000120000
30000000000000000000000
30000000000000000000000
END