# Background Layer

64 # Width
27 # Height

# As this level makes use of the cloud ground this file is just going to provide the background that will be visible for the top portion of the ground
# As the ground is half transparent

0000000000000000000000000000000000000000000000000000000000000000
0000000000000000000000000000000000000000000000000000000000000000
0000000000000000000000000000000000000000000000000000000000000000
0000000000000000000000000000000003600000000000000000000000000000
0000000000000000000000000000000041150000000000000000000000000000
0000000000000000000000000000000311116000000000000000000000000000
0000000000000000000000000000003111111500360000000000000000000000
0000000000000000000000000000041111111154115000000000000000000000
0000000000000000000000000000311111111111111600000000000000000000
0000000000000000000000000004111111111111111150000000000000000000
0000000000000000000000000031111111111111111115000000000000000000
0000000000000000000000000081111111111111111119000000000000000000
0000000000000000000000000007111111111111111115000000000000000000
0000000000000000000000000000811111111111111111500000000000000000
0000000000000000000000000000411111111111111111900000000000000000
000000000000000000000000000311111111111111111A000360000000000000
0000000000000000000000000008111111111111111115004115000000000000
0000000000000360000000036000711111111111111111631111600000000000
0000000000004115000000411500411111111111111111111111150000000000
0000000000031111600003111163111111111111111111111111115000000000
0000000000411111150041111111111111111111111111111111119000000000
0000000003111111115311111111111111111111111111111111116000000000
0000000008111111111111111111111111111111111111111111111500000000
00000000007111111111111111111111111111111111111111111--150000000
00000000003111111111111111111111111111111111111111111--190000000
00000000007111111111111111111111111111111111111111111--900000000
33333333333333333333333333333333333333333333333333333--333333333

END