# Background Layer
# Width, With the end section at the end not included
156
# Height
27
# Ending Type
0
# Amount of sprites on the sprite sheet width
9
# Amount of sprites on sprite sheet height
7

00000000000000000000000000000000000000000000000000000000000000000000000000000000000000000000000000000000000000000000000000000000000000000000000000008000800
00000000000000000000000000000000000000000090000800900000000000000000000000000000000000000000000000000000000000000000000070900000000000000000000000000000000
00000008000000007000080000000000000000000000000000007000000000000000000000000000000008000000000000000800000000000000000000000000000000000000000000000000000
00000000000000000000000000000000000008900000000800000000000000000000000000000008000000000000000000000000000000000000000000000000000000000000000000000000000
00000000000000907000000800000000000000000000000000000000000070000000000000000000000000000000009000000000080070000000000000000000000000000000000000000000000
00000000000000000098000000000000000000000000000000000000000000000000000000000000000000000000080000000000000000000000700000000000000000000080000000000000000
00000000000000000000000000000000000000000000000000000000000000000000000000000000000000000009009000000000000000000000000000000000000000000000000000000000000
00000000000000000000000000000000000000000000000000000000000000000000008000000000000000000000000000000000000000000000000000000000000700000000--0000000000000
00000000000000000000000000000000000000000000000000000000000000000000000000090700000000000000000000000000000000000000000000000000000000000000--0000000000000
0000000000000000000000000000000000000000000000000000000000000000000000000000000000LMMNs80000000000000000000000000000000080000000000000000000--0000000080000
0000000000000000000000000000000000000000000000000000000000000000000000000000000000JQQPr00000000000000000000000000000000000000000000000000000--0000000000000
0000000000000000000000000000000000000000000000000000000000000000000000000000000000wxxxy00000000000000000000000000000000000000000000000000000--0000000000000
00000000000000000000000000000000000000000000000000000000000000000000000000000000000000000000000000000000000000000000000000000000000000000000--0000000000000
00000000000000000000000000000000000000000000000000000000000000000000000000000000000000000000000000000000000000000000000000000000000000000000--0000000000000
00000000000000000000000000000000000000000000000000000000000000000000000000000000000000000000000000000000000000000000000000000000000000000000--0000000000000
00000000000000000000000000000000000000000000000000000000000000000000000000000000000000000000000000000000000000000000000000000000000000000000--0000000000000
00000000000000000000123000000000000000000000000000000000000000000000000000000000000000000000000000000000000000000000000000000000000000000000--0000000000000
000000012230000000004560000000000000000012300000000000000000000000000000012300000000000000000000000000012223000000000000000000000000000fghs0--0000000000000
000000045560000000000000000000000000000045600000000000000000000000000000045600000000000000000000000000045556000000000000000000000000000ejur0--0012300DE0000
00000000000000000000000000000000kllms00000000122230000000000000000000000000000000000000000000000000000000000000000000000000000000000000ejur0000045600CGE000
00000000000000000000000000000000vnnor0000000045556000000000000000000000000000000000VWWWWWXs00000000000000000000000000000000000000000000ejur0000000000CIF000
00000000000000000VWXs00000000LMMNpnor000000000000000000DE00000000000000000000000000UcccccYr000--000000000000000000000000000000000000000ejur000000000DHIF000
00DE0000000000000UcYr00000000KRROqnor000000000000000DEDHFDE0DE0000000000000000000LMMMMMNaYr00000000000000000000000000000000000000000000ejur00000000DHIIF000
0DHFDEDE0000000LMNaYr0000fggghSROqnor000000000000000CGHGHIF0CGE000000000000000000KRRRRRObYr0-0000000-000-00000000000--0DE000000000000LMNzur0--00000CIIIF000
0CGHIFCGE000000KRObYr0000ejjjuTRfgggghs000BBBBBB000DIIIIIIFDHIF00BB000000000000fggggghSObYr00000000--000--000000--00--0CGE00000000000KROAur0--00--0CIIIGE00
0CIIIGHIF0BBB00JQPbZr0000dtttiTQdttttir-----------------------------000000BBB00dtttttiTPbZr0000000---000---0BBB0--00--DGIF00000000000JQPAir0--00--0CIIIIF00
--------------------------------------------------------------------0000----------------------00-----000-----------------------------------0---------------

END