# Width
21
# Height
26
# Ending type (just a place holder, as this is the ending type)
-2
# Amount of sprites on width
4
# Amount of sprites on height
2
# Data store for referencing against
500000000000000000000
500000000000000000000
500000000000000000000
500000000000000000000
500000000000000000000
500000000000000000000
500000000000000000000
500000000000000000000
500000000000000000000
500000000000000000000
500000000000000000000
500000000000000000000
500000000000000000000
500000000000000000000
500000000000000000000
500000000000000000000
500000000000000000000
500000000000000000000
500000000000000000000
500000000000000000000
500000012000000000000
500000034000000000000
500000031200000000000
500000030400000000120
500000030120000000340
500000120040000001240
END