# Width
21
# Height
26
# Ending type (just a place holder)
-2
# Amount of sprites on width
4
# Amount of sprites on height
2
# Data store for referencing against
700000000000000000000
700000000000000000000
700000000000000000000
700000000000000000000
700000000000000000000
700000000000000000000
700000000000000000000
700000000000000000000
700000000000000000000
700000000000000000000
700000000000000000000
700000000000000000000
700000000000000000000
700000000000000000000
700000000000000000000
700000000000000000000
700000000000000000000
700000000000000000000
700000000000000000000
700000000000000000000
700000122300000000000
700000466500000000123
700000466500000000465
700000466500000012365
700000461223000046565
700000464665000046565
END