# Background file
16 # Width
27 # Height

# 0 is the black background sprite
# 1 is the blue block 

1111111111111111
1111111111111111
1111111111111111
111----------111
111-000--000-111
111-000--000-111
111-00000000-111
111-00000000-111
111-00000000-111
111-00000000-111
111-00000000-111
1---00000000---1
-00000000000000-
-00000000000000-
-00000000000000-
-00000000000000-
-00000000000000-
-00000000000000-
-00000000000000-
-00000000000000-
-00000000000000-
-00000000000000-
-00000000000000-
-00000000000000-
--0000000000000-
--0000000000000-
11-------------1

END