# Background Layer

155 # Width
27  # Height
0   # Ending Type

00000000000000000000000000000000000000000000000000000000000000000000000000000000000000000000000000000000000000000000000000000000000000000000000000000000000
00000000000000000000000000000000000000000000000000000000000000000000000000000000000000000000000000000000000000000000000000000000000000000000000000000000000
00000000000000000000000000000000000000000000000000000000000000000000000000000000000000000000000000000000000000000000000000000000000000000000000000000000000
00000000000000000000000000000000000000000000000000000000000000000000000000000000000000000000000000000000000000000000000000000000000000000000000000000000000
00000000000000000000000000000000000000000000000000000000000000000000000000000000000000000000000000000000000000000000000000000000000000000006780000000000000
00000000000000000000000000000000000000000000000000000000000000000000000000000000000000000000000000000000000000000000000000000000000000000009AB0000000000000
00000000000000000000000000000000006780000000000000000677778000000000000000000000000000000000000000000000000000000000000000067780000000000000000006777800000
00000000000000000000677780000000009AB00000000000000009AAAAB00000000000000000000000000000000000000000000000000000000000000009AAB0000000000000000009AAAB00000
000000000000000000009AAAB0000000000000000677800000000000000000000000000000000000000000000000000000000000000000000000000000000000000000000000000000000000000
000000000000000000000000000000000000000009AAB00000000000000000000000000000000000000000000000000000000000000000000000000000000000000000000000000000000000000
00000000000000000000000000000000000000000000000000000000000000000000000000000000000000000000000000000000000000000000000000000000000000000000000000000000000
00000000000000000000000000000000000000000000000000000000000000000000000000000000000000000000000000000000000000000000000000000000000000000000000000000000000
00000000000000000000000000000000000000000000000000000000000000000000000000000000000000000000000000000000000000000000000000000000000000000000000000000000000
00000000000000000000000000000000000000000000000000000000000000000000000000000000000000000000000000000000000000000000000000000000000000000000000000000000000
00000000000000000000000000000000000000000000000000000000000000000000000000000000000000000000000000000000000000000000000000000000000000000000000000000000000
00000000000000000000000000000000000000000000000000000000000000000000000000000000000000000000000000000000000000000000000000000000000000000000000000000000000
00000000000000000000000000000000000000000000000000000000000000000678000000000000000000035000000000000000000000000000000000000000000000000000000000000000000
000000000000000000000000000067778000000000000000HI0000000000000009AB000000--0000000000----00000000000000000000000000000067780000000000000000000006777800000
0000000678000000000000----009AAAB00000------0000CFI00000000000000000000000--000000000-1111-000000000000000000000000000009AAB0067800000000---000009AAAB00000
00000009AB000000000000----000000000000------0000CDE00000000000000000000000--00000000-11111-000000000----00000000000000000000009AB00000000---000000000000000
00000000000000000000-------0000000000000--00000HGDE000000000--0000000000000000000000-11111-00000000-1111-0000000000000000000000000000-00------0000000000000
00HI00000000000000--1111111-000000000000--0000HGDDE000000000-----0000000000000000000-11111-0350000-111111-000000000000000000000000000000-111--0000000000000
0HGEHI0000003445--1111111111-0000000-000--00HICDDDE00000-------11-00000HI0000000000-1111111-------11111111-000--0000000--00000000000000-111111--00000000000
0CFGDFI000------1111111111111-0000000000--00CFGDDDFI00--111----111-0000CFI00000000-111111111111111111111111-00--0000000--00000000--000-111111111--00000HI00
0CDFGDE0--11111111111111111111--00344500--0HGDDDDDDE--1111111111111--0HGDE3445----11111111111111111111111111-0--0350000--03444450--00-111111111111--000CFI0
--------111111111111111111111111-------0------------11111111111111111---------1111111111111111111111111111111-------00---------------111111111111111--HGDE0
2222222222222222222222222222222222222220-22222222222222222222222222222222222222222222222222222222222222222222222222200-2222222222---111111111111111111-----

END
