# Width
20
# Height
26
# Ending type (just a place holder)
-2
# Amount of sprites on width
4
# Amount of sprites on height
2
# Data store for referencing against
60000000000000000000
60000000000000000000
60000000000000000000
60000000000000000000
60000000000000000000
60000000000000000000
60000000000000000000
60000000000000000000
60000000000000000000
60000000000000000000
60000000000000000000
60000000000000000000
60000000000000000000
60000000000000000000
60000000000000000000
60000000000000000000
60000000000000000000
60000000000000000000
60000000000000000000
60000000000000000000
60000233400000000000
60000100500000000234
60000100500000000105
60000100500000023405
60000102334000010505
60000101005000010505
END