# Width
24
# Height
26
# Ending type (just a place holder)
-2
# Amount of sprites on width
4
# Amount of sprites on height
2
# Data store for referencing against
300000000000000000000000
300000000000000000000000
300000000000000000000000
300000000000000000000000
300000000000000000000000
300000000000000000000000
300000000000000000000000
300000000000000000000000
300000000000000000000000
300000000000000000000000
300000000000000000000000
300000000000000000000000
300000000000000000000000
300000000000000000000000
300000000000000000000000
300000000000000000000000
300000000000000000000000
300000000000000000000000
300000000000000000000000
300000000000000000000000
300000000000000000000000
300000000000000000000000
300000000000000000000000
300000000000120000000000
300000000001002120000000
300000000010001002001200
END